Name,Science,English,Math,History,Biology,Total,Average,Grades
flap,100,100,100,100,100,500,100.0,A+
filip,95,95,95,95,95,475,95.0,A
mario,90,90,90,90,90,450,90.0,A-
caleb,89,89,89,89,89,445,89.0,B+
nina,85,85,85,85,85,425,85.0,B
sasha,80,80,80,80,80,400,80.0,B-
Sam,21,95,90,85,89,380,76.0,C+
ben,23,38,1,1,1,64,12.8,F
Moyo,100,80,100,20,10,310,62.0,D-
Moyo,100,80,100,20,10,310,62.0,D-
kyra,90,90,90,90,90,450,90.0,A-
kyra,57,57,57,57,57,285,57.0,E