Name,Maths,English,Science,History,Geography,Total,Average,Grade
Tami,70,70,70,70,70,350,70.0,B-
Jeida,70,70,70,70,70,350,70.0,B-
Tami,100,70,70,89,70,399,79.8,B-
Nathan Lee,90,87,70,90,98,435,87.0,B
Jayden,70,70,70,70,70,350,70.0,B-
Moyo Adeola,90,83,74,92,96,435,87.0,B
Moyo Adeola,90,83,74,92,96,435,87.0,B
Moyo Adeola,90,83,20,10,96,299,59.8,D
Moyo Adeola,90,83,20,90,96,379,75.8,B-
Temi,100,85,90,100,95,470,94.0,A
Aaron,90,50,50,50,50,290,58.0,D
Sean,90,50,50,50,50,290,58.0,D
